GGGGGGGLAARGGGGGGG
LAAAAAAAAAAAAAAAAR
LAAAAAAAAAAAAAAAAR
LAAARGGGGGGGGLAAAR
LAAAAAAAAAAAAAAAAR
LGLAARGLAARGLAARGR
LAAAAAAWAAWAAAAAAR
LAARLAAWAAWAARLAAR
LAAAAAAAAAAAAAAAAR
LAAARGGGGGGGGLAAAR
LAAAAAAAAAAAAAAAAR
LGLAAAAAAAAAAAARGR
LAAAAARGGGGLAAAAAR
LAAAAAAAAAAAAAAAAR
LGLAAAAAAAAAAAARGR
LAAAARGGGGGGLAAAAR
LAAAAAAAAAAAAAAAAR
GGGGGGGLAARGGGGGGG